00000000000000000000000000000000000000000000
00000000000000000000000000000222222200000000
00000002222200000000000000000000000000000020
00000000000000000000000000220000000000000210
00000000000000000222220000000000000000022112
00000000000000000000000000000000000000000000
00000222222200000000000000022222220000000000
00000000000000000000000000000000000000000000
00000000000000000000000000000000000000000000
00002222000000022220000000222200000002222000
22221111222222211112222222111122222221111222
11111111111111111111111111111111111111111111
11111111111111111111111111111111111111111111
11111111111111111111111111111111111111111111
11111111111111111111111111111111111111111111
11111111111111111111111111111111111111111111
11111111111111111111111111111111111111111111