00000000000000000000000000000000000000000000
00000000000000000000000000000000000000000000
00000000000000000000000000000000000000000000
00000000000000000000000000000000000000000000
00000000000000000222220000000220220000022222
00000000000000000000000000000111100000000000
00000222222200000000000000011111110000000000
00000000000000000000000000000011100000000000
00000000000000000000000000000000000000000000
00002222000000022220000000222200000002222000
22221111222222211112222222111122222221111222
11111111111111111111111111111111111111111111
11111111111111111111111111111111111111111111
11111111111111111111111111111111111111111111
11111111111111111111111111111111111111111111
11111111111111111111111111111111111111111111
11111111111111111111111111111111111111111111